NO ./images_xpm/text_NO.xpm
SO ./images_xpm/text_SO.xpm
WE ./images_xpm/text_WE.xpm
EA ./images_xpm/text_EA.xpm

F  41,97,196
C 71,169,105

        1111111111111111111111111
        1000000000110000000000001
        1011000001110000000000001
        1001000000000000000000001
111111111011000001000000000000001
100000000011000001000111111111111
111101111111110110000001000111111
111101111111110110101001000111111
110000001101010000000000100011111
100000000000000010000000000111111
100000000000000000000000001111111
110000011111111111101000N0111
11110111 1110101 101111010001
11111111 1111111 111111111111
