NO ./images_xpm/text_NO.xpm
SO ./images_xpm/text_SO.xpm
WE ./images_xpm/text_WE.xpm
EA ./images_xpm/text_EA.xpm

F  41,97,196
C 71,169,105



        1111111111111111111111111
        1000000000110000000000001
        1000000000110000000000001
        1001000001110000000000001
111111111001000001110000000000001
100000000001000001110001111111111
11100111111110011100000010001
11100111111110011101010010001
11000000110000011100000010001
10000000000000000000000010001
10000000000000000000010000001
11000001110000011110010000N01
11110011 1110001 110010000001
11111111 1111111 111111111111
